0|0|0|0|0|0|0|0|0|0|0|0|0|0|0|0|0|0|0|0|0|0|
____________________________________________
0|0|0|0|0|0|0|0|0|0|0|0|0|0|0|0|0|0|0|0|0|0|
____________________________________________
0|0|0|0|0|0|1|1|1|1|1|1|1|1|1|1|0|0|0|0|0|0|
____________________________________________
0|0|0|0|0|0|1|1|1|1|1|1|1|1|1|1|0|0|0|0|0|0|
____________________________________________
0|0|2|2|2|0|1|1|1|1|1|1|1|1|1|1|0|3|3|3|0|0|
____________________________________________
0|0|2|2P2|1|1U1D1U1D1U1D1U1D1U1|1|3|3|3|0|0|
____________________________________________
0|0|2|2|2|0|1|1|1|1|1|1|1|1|1|1|0|3|3|3|0|0|
____________________________________________
0|0|0|0|0|0|1|1|1|1|1|1|1|1|1|1|0|0|0|0|0|0|
____________________________________________
0|0|0|0|0|0|1|1|1|1|1|1|1|1|1|1|0|0|0|0|0|0|
____________________________________________
0|0|0|0|0|0|0|0|0|0|0|0|0|0|0|0|0|0|0|0|0|0|
____________________________________________
0|0|0|0|0|0|0|0|0|0|0|0|0|0|0|0|0|0|0|0|0|0|
____________________________________________
